NO ./textures/brick.xpm
SO ./textures/camouflage.xpm
WE ./textures/grass.xpm
EA ./textures/meduza.xpm

F 0,100,0
C 0,0,100

1111111111111111111111111
1000000000110000000000001
1011000001110000000000001
100100000000000000000000111111111
111111111011000001110000000000001
100000000011000001110111111111111
11110111111111011100000000001
11110111111111011101010010001
11000000110101011100000010001
10000000000000001100000010001
100000000N0000000001010010001
1100000111010101111101011000111
11110111 1110101 1111101111111
10000000100000011   11001
10000000000000001   10001
1000000000000000111110001
1000000000000000000000001
1000000000000000000000001
1000000000000000000000001
1000000000000000000000001
100000000000000000000001
1000000000010000000000001
10000000001 1000000000001
1000000000010000000000001
1000000000000000000000001
1000000000000000000000001
1000000000000000000000001
1000000000000000000000001
1000000000000000000000001
1100000000000000000000001
1000000000000000000000001
11111000000000000000000011111
    1000000000000000000000011
1111100000000000000000011111
1100000000000000000000001
1100000000000000010100001
1101111011111111111 11111
110000001
111111111